111111111111111111111111111111111
1C000000C00000C000000000000000001
1C0000010C11110011110011110000001
1E0000010000010000010000010000001
1000P0010011110011110000010000001
100000010000C10C00010000010000001
100000010011110C11110000010000001
1C000000C00000C000000000000000001
111111111111111111111111111111111