1111111111111111111111111111111111
1C0000C00000C010000001000001000001
1E00010100100000101001000001010111
1P00010010101010001001000000010001
110000000C00C010000000001000111011
1111111111111111111111111111111111
